111111111111111
101010000101001
100001011000101
110100001010101
101101100010101
1000P0001010101
101111101111101
100100C00000001
110111E11111111
100010C00010101
111010101010001
1000101C1010101
101111101010101
100000001000101
111111111111111
