1111111111111111
1E00001100000101
10C1100000000001
1C00100010000101
1110100100000011
1E00001100000101
1PC1100000000001
1C00100010000101
1111111111111111