1111111111111111111111111111111111
1E0000C000000110000010000001000001
101C010C00100000101001000100010101
1010010010101010001001000100010101
1P00000111000000011000000011000001
1111111111111111111111111111111111
