111111111111111
1000P0001001001
100111001000001
111000011011001
100C11000011001
1100100E0010001
10000C000100001
1E010E011010001
1C0011011010001
1E0001111000101
111111111111111
